NO ./textures/simonkraft/mossy_cobblestone1.xpm
SO ./textures/simonkraft/mossy_cobblestone1.xpm
WE ./textures/simonkraft/mossy_cobblestone1.xpm
EA ./textures/simonkraft/mossy_cobblestone1.xpm




F 139,99,58
C 171,154,137


11111111111111111111111111111111111111
1001001001001001001001001001001001001
1001001001001001000001001001001001001
100100100100100100001001001001001001
100100100000100100000001001001001001
1000000000000000001111111111111111111
100001111111100000100100100100101
111100000000000100100100100101111
10000001010100000S1001001001001001111
1111111111111111111111111111111111111



