   WE                            textures/wolfenstein/eagle.xpm 
NO      textures/wolfenstein/blue_stone.xpm



SO textures/wolfenstein/blue_stone.xpm

F   69, 222, 199

EA textures/wolfenstein/eagle.xpm



C 235, 198, 52

1111111111111111111111111111111111111111111111111111111
10S0000000000000000000000000000000000000000000000000001
1011111111111111111111111111111111111111111111101111111
1011111111111111111111111111111111111111111111101111111
1011111111111111111111111111111111111111111111101111111
1011111111111111111111111111111111111111111111101111111
1011111111111111111111111111111111111111111111101111111
1011111111111111111111111111111111111111111111101111111
1011111111111111111111111111111111111111111111101111111
1011111111111111111111111111111111111111111111101111111
1011111111111111111111111111111111111111111111101111111
1011111111111111111111111111111111111111111111101111111
1011111111111111111111111111111111111111111111101111111
1011111111111111111111111111111111111111111111101111111
1011111111111111111111111111111111111111111111101111111
1011111111111111111111111111111111111111111111101111111
1011111111111111111111111111111111111111111111101111111
1011111111111111111111111111111111111111111111101111111
1111111111111111111111111111111111111111111111111111111

