   WE                            textures/wolfenstein/blue_stone.xpm
NO      textures/wolfenstein/blue_stone.xpm



SO textures/wolfenstein/blue_stone.xpm

F   255, 255, 255

EA textures/wolfenstein/blue_stone.xpm



C 0, 0, 0

1111111111111111111111111111111111111111111111111111111
10S0000000000000000000000000000000000000000000000000001
1010000000000000000000000000000000000000000001111111101111111
1011110000000000000000000000000000000000000000001111101111111
1011111111000000000000000000000000000000000000000000111110111111111
10111111100000000000000000000000000000000000000000011111111111111101111111
1011100000000000000000000000000000000000000000011111111111111111101111111
101111100000000000000000000000000000000000000000011111111111111111111101111111
101111111111111111111111111111111111111111111110111111111111111111111111111
1011111111111111111111111111111111111111111111101111111
1011111111111111111111111111111111111111111111101111111
1011111111111111111111111111111111111111111111101111111
1011111111111111111111111111111111111111111111101111111
1011111111111111111111111111111111111111111111101111111
1011111111111111111111111111111111111111111111101111111
1011111111111111111111111111111111111111111111101111111
1011111111111111111111111111111111111111111111101111111
1011111111111111111111111111111111111111111111101111111
1111111111111111111111111111111111111111111111111111111
