WE     textures/simonkraft/bookshelf.xpm
NO     textures/simonkraft/bookshelf.xpm


SO textures/simonkraft/basalt_top.xpm


F 46, 184, 96

C 37,150,190

EA textures/simonkraft/basalt_top.xpm




1111111111111111111111111111111111111111111111111111111
100000000000000000000000000N000000000000000000000000001
1010000000000000000000000000000000000000000001111111101111111
1011110000000000000000000000000000000000000000001111101111111
1011111111000000000000000000000000000000000000000000111110111111111
10111111100000000000000000000000000000000000000000011111111111111101111111
1011100000000000000000000000000000000000000000011111111111111111101111111
101111100000000000000000000000000000000000000000011111111111111111111101111111
101111111000000000000000000000000000111111110111111111111111111111111111
10111111111111000000000000000000000000000111111101111111
10110000000000000000000000000000000000000001111111
10110000000000000000000000000000000000000001111111
1011100000000000000000000000000000000011101111111
101100000000000000000000000000000000011101111111
101100000000000000000000000000000000000000000001111111
1011111111000000000000000000000000000000011101111111
100000000000000000000000000000001000000000000000001111111111111111111
1011111111111111111111111111111111111111111111101111111
1111111111111111111111111111111111111111111111111111111
