NO textures/wolfenstein/blue_stone.xpm
SO textures/wolfenstein/blue_stone.xpm
WE textures/wolfenstein/blue_stone.xpm
EA textures/wolfenstein/blue_stone.xpm

F 255,255,255
C 255,255,255

1111111111111111111111111
1000000000000000000000001
1000000000001110111111111111
1010000000010000000000101
10101111110100000001110101
1010100000010100000010101
1010101111110101111010101
1010101000000101000010101
1010101011111101011110101
1010000010000000010000001
1011111110111111110111111
1000000000000S000000000001
1111111111111111111111111
